{
  "title": "Tutorial",
  "published": true,
  "world": "shire",
  "grassShader": "grass",
  "waterShader": "water",
  "puzzleLevel": true,
  "tileMap": {
    "size": 16,
    "terrainTypes": [
      "water",
      "lava",
      "dirt",
      "brick",
      "rock",
      "forest",
      "grass"
    ],
    "terrainMap": [
      [4,4,4,4,4,4,4,4,4,4,4,4,4,4,4,4],
      [4,4,4,4,4,4,4,4,4,4,4,4,4,4,4,4],
      [4,4,4,4,4,4,4,4,4,4,4,4,4,4,4,4],
      [4,4,4,4,4,4,4,4,4,4,4,4,4,4,4,4],
      [4,4,4,4,4,4,4,4,4,4,4,4,4,4,4,4],
      [4,4,4,4,4,4,4,4,4,4,4,4,4,4,4,4],
      [4,4,4,4,4,4,4,4,4,4,4,4,4,4,4,4],
      [4,4,4,4,4,4,4,4,4,4,4,4,4,4,4,4],
      [4,4,4,4,4,4,4,4,4,4,4,4,4,4,4,4],
      [4,4,4,4,4,4,4,4,4,4,4,4,4,4,4,4],
      [4,4,4,4,4,4,4,4,4,4,4,4,4,4,4,4],
      [4,4,4,4,4,4,4,4,4,4,4,4,4,4,4,4],
      [4,4,4,4,4,4,4,4,4,4,4,4,4,4,4,4],
      [4,4,4,4,4,4,4,4,4,4,4,4,4,4,4,4],
      [4,4,4,4,4,4,4,4,4,4,4,4,4,4,4,4],
      [4,4,4,4,4,4,4,4,4,4,4,4,4,4,4,4]
    ],
    "heightMap": [
      [5,5,5,5,5,5,5,5,5,5,5,5,5,5,5,5],
      [5,5,5,5,5,5,5,5,5,5,5,5,5,5,5,5],
      [5,5,5,5,5,5,5,5,5,5,5,5,5,5,5,5],
      [5,5,5,5,5,5,5,5,5,5,5,5,5,5,5,5],
      [5,5,5,5,5,5,5,5,5,5,5,5,5,5,5,5],
      [5,5,5,5,5,5,5,5,5,5,5,5,5,5,5,5],
      [5,5,5,5,5,5,5,5,5,5,5,5,5,5,5,5],
      [5,5,5,5,5,5,5,5,5,5,5,5,5,5,5,5],
      [5,5,5,5,5,5,5,5,5,5,5,5,5,5,5,5],
      [5,5,5,5,5,5,5,5,5,5,5,5,5,5,5,5],
      [5,5,5,5,5,5,5,5,5,5,5,5,5,5,5,5],
      [5,5,5,5,5,5,5,5,5,5,5,5,5,5,5,5],
      [5,5,5,5,5,5,5,5,5,5,5,5,5,5,5,5],
      [5,5,5,5,5,5,5,5,5,5,5,5,5,5,5,5],
      [5,5,5,5,5,5,5,5,5,5,5,5,5,5,5,5],
      [5,5,5,5,5,5,5,5,5,5,5,5,5,5,5,5]
    ]
  },
  "playerSpawn": {
    "x": -300,
    "y": 0,
    "z": -300
  },
  "exitPosition": {
    "x": 300,
    "y": 0,
    "z": 300
  },
  "collectibles": [
    {
      "objectType": "barrel",
      "position": { "x": -100, "y": 0, "z": -100 }
    },
    {
      "objectType": "crate",
      "position": { "x": 0, "y": 0, "z": 0 }
    },
    {
      "objectType": "present",
      "position": { "x": -200, "y": 0, "z": -200 }
    },
    {
      "objectType": "present",
      "position": { "x": 100, "y": 0, "z": -100 }
    }
  ],
  "enemies": [
    {
      "type": "guard",
      "position": { "x": 150, "y": 0, "z": 150 },
      "patrol": {
        "waypoints": [
          { "x": 150, "z": 150 },
          { "x": 250, "z": 150 },
          { "x": 250, "z": 250 },
          { "x": 150, "z": 250 }
        ]
      }
    }
  ]
}
